*.*._.*.*.
*.*...*.*.
*.*...*.*.
.*..**..*.
*.**..**.*
.*..**..*.
.*.*..*.*.
.*.*..*.*.
.*.*..*.*.
....@.....