.+.._.....
.+....*.*.
...*..*+*.
......+...
.***..*.*.
...+....*.
+*.+..*+*.
.*.*......
.*.*..*.*.
.*..@.***.