...._.....
..........
.***.*.*.-
...*.*.*.-
.***.***.-
.*.....*.-
.***...*.-
+.*.*+...+
-.*+*...*-
--..@...--